0,0,0,0,0,0,0,0,0,0,0,0,0,0,0,0,0,0,0,0,0,0,0,0,0
0,0,0,0,0,0,0,0,0,0,0,2,2,2,2,0,0,0,0,0,0,0,0,0,0
0,0,0,0,0,0,0,0,0,0,2,2,T,T,2,2,0,0,0,0,0,0,0,0,0
0,0,0,0,0,0,0,0,0,2,2,0,0,0,0,2,2,0,0,0,0,0,0,0,0
0,0,0,0,0,0,0,0,2,2,0,0,0,0,0,0,2,2,0,0,0,0,0,0,0
0,0,0,0,0,0,0,2,2,0,0,0,0,0,I,0,0,2,2,0,0,0,0,0,0
0,0,0,0,0,0,2,2,0,0,0,0,I,0,0,0,0,0,2,2,0,0,0,0,0
0,0,0,0,0,2,2,T,0,I,0,0,0,S,0,0,0,0,T,2,2,0,0,0,0
0,0,0,0,0,2,T,0,0,0,I,0,0,I,0,0,I,0,0,T,2,0,0,0,0
0,0,0,0,0,2,T,0,0,0,0,0,0,0,I,0,0,0,0,T,2,0,0,0,0
0,0,0,0,0,2,2,T,0,0,0,I,0,0,0,I,0,0,T,2,2,0,0,0,0
0,0,0,0,0,0,2,2,0,0,I,0,0,I,0,0,0,0,2,2,0,0,0,0,0
0,0,0,0,0,0,0,2,2,0,0,0,0,0,I,0,0,2,2,0,0,0,0,0,0
0,0,0,0,0,0,0,0,2,2,0,0,0,0,0,0,2,2,0,0,0,0,0,0,0
0,0,0,0,0,0,0,0,0,2,2,T,2,2,T,2,2,0,0,0,0,0,0,0,0
0,0,0,0,0,0,0,0,0,0,2,2,2,2,2,2,0,0,0,0,0,0,0,0,0
0,0,0,0,0,0,0,0,0,0,0,0,0,0,0,0,0,0,0,0,0,0,0,0,0
0,0,0,0,0,0,0,0,0,0,0,0,0,0,0,0,0,0,0,0,0,0,0,0,0
